XXXXXXXXXXXXXXXXXXXXXXXXXXXXXXXXXXXXXXXXXXXXXXXXXXXXXXXXXXXXXXXXXXXXXXXXXXXXXXXXXXXXXXXXXXXXXXXXXXXXXXXXXXXXXXXXXXXXXXX
X                                                                                                                     X
X                                                                                                                     X
X                                                                                                                     X
X                                                                                                                     X
X                                                                                                                     X
X                                                                                                                     X
X                                                                                                                     X
X                                                                                                                     X
X                                                                                                                     X
X                                                                                                                     X
X                                                                                                                     X
X                                                                                                                     X
X                                          XXXXXXXXX      XXXXXXXXXXXXXXXXXXXXXXXXXXXXXXXXXXXXXX                      X
X                                          X  X  X X      X                              B     X                      X
X                                          X       X      X XXXXXXXXXXXXXXXXXXXXXXXXXXXXXXXXXX X                      X
X                                          X   X   X      X X                                X X                      X
X                                          XX X    XXXXXXXX XXXXXXXX                         X X                      X
X                                          XP X                    X                         X X                      X
X                                          XX XX X XXXXXXXXXXXXXX  X        XXXXXXXXXXXXXXXXXX XXXXXXXXXXXXXXXXXXX    X
X                                          X  XX   X               X        X                                    X    X
X                                          XX X    XXXXXXXXX XXXXXXX        X XXXXXXXX XXXXXXXXXXXXXXXXXXXXXXXXX X    X
X                                          X    X  X       X X              X X                                X X    X
X                                          XX X    XX XXXX   X              X X XXXXXXXXXXXXXXXXXXXXXXXXXXXXX  X X    X
X                                          X       X       X X              X X X                   B       X  X X    X
X                                          XX X  X XXXXXXXXX X      O       X X X XXXXXXXXXXXX XXXXXXX XXXX X  X X    X
X                                          X     X     O     X              X X X X          X X          X X  X X    X
X                                          XXXXXXXXXXXXXX XXXX              X X X XXXXXXXX XXX XXXXXXXXXXXX X  X X    X
X                                                  0    X X                 X X X                           X  X X    X
X                                                       X X              P  X X X XXXXX XXXXXX XXXXXXXXXXXX X  X X    X
X                                                       X X                 X X X X          X X          X X  X X    X
X                                            XXXXXXXXXXXX XXXXXXXXXXXXXXXXXXX XXX XXXXXXXXXXXX XXXX XXXXXXX XXXX XX   X
X                                            X                     R                    R                         X   X
X                                            XXXXXXXXXXXXXXXXXXXXXXXXXXXXXXXXXXXXXXXXXXXXXXXXXXXXXXXXXXXXXXXXXXXXXX   X
X                                                                                                                     X
X                                                                                                                     X
X                                                                                                                     X
X                                                                                                                     X
X                                                                                                                     X
X                                      RRRRRR                                                                         X
X                                            BBBBBB                                                                   X
X                                                  OOOOOO                                                             X
X                                                        PPPPP                                                        X
X                                                                                                                     X
XXXXXXXXXXXXXXXXXXXXXXXXXXXXXXXXXXXXXXXXXXXXXXXXXXXXXXXXXXXXXXXXXXXXXXXXXXXXXXXXXXXXXXXXXXXXXXXXXXXXXXXXXXXXXXXXXXXXXXX