XXXXXXXXXXXXXXXXXXXXXXXXXXXXXXXXXXXXXXXXXXXXXXXXXXXXXXXXXXXXXXXXXXXXXXXXXXXXXXXXXXXXXXXXXXXXXXXXXXXXXXXXXXXXXXXXXXXXXXX
X                                                                                                                     X
X                                                                                                                     X
X                                                                                                                     X
X                                                                                                                     X
X                                                                                                                     X
X                                                                                                                     X
X                                                                                                                     X
X                                                                                                                     X
X                                                                                                                     X
X                                                                                                                     X
X                                                                                                                     X
X                                                                                                                     X
X                                          XXXXXXXXX      XXXXXXXXXXXXXXXXXXXXXXXXXXXXXXXXXXXXXX                      X
X                                          X  X  X X      X                              B     X                      X
X                                          X       X      X XXXXXXXXXXXXXXXXXXXXX XXXXXXXXXXXX X                      X
X                                          X   X   X      X X                   X X          X X                      X
X                                          XX X    XXXXXXXX XXXXXXXX            X X          X X                      X
X                                          XP X                    X            X X          X X                      X
X                                          XX XX X XXXXXXXXXXXXXX  XXXXXXXXXXXXXX XXXXXXXXXXXX XXXXXXXXXXXXXXXXXXX    X
X                                          X  XX   X                                                             X    X
X                                          XX X    XXXXXXXXX XXXXXXXXXXXXXXXX XXXXXXXX XXXXXXXXXXXXXXXXXXXXXXXXX X    X
X                                          X    X          X X              X X                                X X    X
X                                          XX X    XX XXXX   X  XXXXXXXXXX  X X XXXXXXXXXXXXXXXXXXXXXXXXXXXXX  X X    X
X                                          X       X       X X  X   O    X  X X X                           X  X X    X
X                                   XXXXXXXXXXX  X XXXXXXXXX X  X       XX  X X X XXXXXXXXXXXX XXXXXXX XXXX X  X X    X
X                                   X            X           X  XXXX XXXXX  X X X X          X X          X X  X X    X
X                                   X XXXXXXXXXXXXXXXXXXX XXXX     X X      X X X XXXXXXXX XXX XXXXXXXXXXXX X  X X    X
X                                   X X                 X X        X X      X X X                           X  X X    X
X                                   X X                 X X        X X      X X X XXXXX XXXXXX XXXXXXXXXXXX X  X X    X
X                                   X X                 X X        X X      X X X X          X X          X X  X X    X
X                                   X XXXXXXXXXXXXXXXXXXX XXXXXXXXXX XXXXXXXX XXX XXXXXXXXXXXX XXXX XXXXXXX XXXX XXXX X
X                                   X          R                                                                    X X
X                                   XXXXXXXXXXXXXXXXXXXXXXXXXXXXXXXXXXXXXXXXXXXXXXXXXXXXXXXXXXXXXXXXXXXXXXXXXXXXXXXXX X
X                                                                                                                     X
X                                                                                                                     X
X                                                                                                                     X
X                                                                                                                     X
X                                                                                                                     X
X                                                                                                                     X
X                                                                                                                     X
X                                                                                                                     X
X                                                                                                                     X
X                                                                                                                     X
XXXXXXXXXXXXXXXXXXXXXXXXXXXXXXXXXXXXXXXXXXXXXXXXXXXXXXXXXXXXXXXXXXXXXXXXXXXXXXXXXXXXXXXXXXXXXXXXXXXXXXXXXXXXXXXXXXXXXXX