XXXXXXXXXXXXXXXXXXX
X        X        X
X XXXX XXX 0    X X
X X      X    XXX X
X                 X
X    XXXX  XXX    X
XXX XX RPBO  XXX  X
X    XXXXXXXXX    X
X                 X
XXXXXXXXXXXXXXXXXXX