XXXXXXXXXXXXXXXXXXXXXXXXXXXXXXXXXXXXXXXXXXXXXXXXXXXXXXXXXXXXXXXXXXXXXXXXXXXXXXXXXXXXXXXXXXXXXXXXXXXXXXXXXXXXXXXXXXXXXXX
X                                                                                                                     X
X                                                                                                                     X
X                                                                                                                     X
X                                                                                                                     X
X                                                                                                                     X
X                                                                                                                     X
X                                                XXXXXXXXXXXXXXXXXXXXXXXXXXXXXXXXXXXXXXXX                             X
X                                                X                                      X                             X
X                      XXXXXXXXXXXXXXXXXXXXXXXXXXX XXXXXXXX XXXXXXXXXXXXXXXXXXXXXXXXXXX X                             X
X                      X                           X      X X                         X X                             X
X                      X XXXXXXXXXXXXXXXXXXXXXXXXX X      X X                         X X                             X
X                      X X                       X X      X X                         X X                             X
X                      X X                 XXXXXXX X      X XXXXXXXXXXXXXXXXXXXXXXXXXXX XXXXXXXX                      X
X                      X X                 X XX XX X      X                                    X                      X
X                      X X                 X X     X      X XXXXXXXXXXXXXXXXXXXXX XXXXXXXXXXXX X                      X
X                      X X                 X   X   X      X X                   X X          X X                      X
X                      X X                 XX XX  XXXXXXXXX XXXXXXXX            X X          X X                      X
X                      X X                 X  X                    X            X X          X X                      X
X                      X X                 XX XX X XXXXXXXXXXXXXX  XXXXXXXXXXXXXX XXXXXXXXXXXX XXXXXXXXXXXXXXXXXXX    X
X                      X XXXXXXXXXXXXXXXXXXX  XX   X                                                             X    X
X                      X                      X    XXXXXXXXX XXXXXXX XXXXXXXX XXXXXXXX XXXXXXXXXXXXXXXXXXXXXXXXX X    X
X                      X XXXXXXXXXXXXXXXXXXXX   X          X X     X X      X X                                X X    X
X                      X X                 XX X    XX XXXX   X  XXXX XXXXX  X X XXXXXXXXXXXXXXXXXXXXXXXXXXXXXX X X    X
X                      X X                 X       X       X X  X   A    X  X X X                           X  X X    X
X                      X X          XXXXXXXXXXX XX XXXXXXXXX X  X  ARA   X  X X X XXXXXXXXXXXX XXXXXXX XXXX X XX X    X
X                      X X          X            X           X  X   A    X  X X X X          X X          X X  X X    X
X                      X X          X XXXXXXXXXXXXXXXXXXX XXXX  XXXX XXXXX  X X X XXXXXXXX XXX XXXXXXXXXXXX XX X X    X
X                      X XXXXXXXXXXXX X                 X X        X X      X X X                           X  X X    X
X                      X              X                 X X        X X      X X X XXXXX XXXXXX XXXXXXXXXXXX X XX X    X
X                      XXXXXXXXXXXXXX X                 X X        X X      X X X X          X X          X X  X X    X
X                                   X XXXXXXXXXXXXXXXXXXX XXXXXXXXXX XXXXXXXX XXX XXXXXXXXXXXX XXXX XXXXXXX XXXX XXXX X
X                                   X                                                                               X X
X                                   XXXXXXXXXXXXXXXXXXXXXXXXXXXXXXXXXXX XXXXXXXXXXXXXXXXXXXXXXXXXXXXXXXXXXXXXXXXXXXXX X
X                                                                     X X                                             X
X                                                                     X X                                             X
X                                   XXXXXXXXXXXXXXXXXXXXXXXXXXXXXXXXXXX XXXXXXXXXXXXXXXXXXXXXXXXXXXXXXXXXXXXXXXXXXXXX X
X                                   X                                                                     0     A AAX X
X                                   XXXXXXXXXXXXXXXXXXXXXXXXXXXXXXXXXXXXXXXXXXXXXXXXXXXXXXXXXXXXXXXXXXXXXXXXXXXXXXXXX X
X                                                                                                                     X
X                                                                                                                     X
X                                                                                                                     X
X                                                                                                                     X
X                                                                                                                     X
XXXXXXXXXXXXXXXXXXXXXXXXXXXXXXXXXXXXXXXXXXXXXXXXXXXXXXXXXXXXXXXXXXXXXXXXXXXXXXXXXXXXXXXXXXXXXXXXXXXXXXXXXXXXXXXXXXXXXXX