XXXXXXXXXXXXXXXXXXXXXXXXXXXXXXXXXXXXXXXXXXXXXXXXXXXXXXXXXXXXXXXXXXXXXXXXXXXXXXXXXXXXXXXXXXXXXXXXXXXXXXXXXXXXXXXXXXXXXXX
X                                                                                                                     X
X                                                                                                                     X
X                                                                                                                     X
X                                                                                                                     X
X                                                                                                                     X
X                                                                                                                     X
X                                                                                                                     X
X                                                                                                                     X
X                                                                                                                     X
X                                                                                                                     X
X                                                                                                                     X
X                                                                                                                     X
X                                          XXXXXXXXX                                                                  X
X                                          X  X  X X                                                                  X
X                                          X       X                                                                  X
X                                          X   X   X                                                                  X
X                                          X X X   X                                                                  X
X                                          X   X   X                                                                  X
X                                          X XXXXX X                                                                  X
X                                          X   X   X                                                                  X
X                                          X      XX                                                                  X
X                                          X       X0                                                                 X
X                                          XXXX    X                                                                  X
X                                          X  X    X                                                                  X
X                                          X     X X                                                                  X
X                                          X RPBOX X                                                                  X
X                                          XXXXXXXXX                                                                  X
X                                                                                                                     X
X                                                                                                                     X
X                                                                                                                     X
X                                                                                                                     X
X                                                                                                                     X
X                                                                                                                     X
X                                                                                                                     X
X                                                                                                                     X
X                                                                                                                     X
X                                                                                                                     X
X                                                                                                                     X
X                                                                                                                     X
X                                                                                                                     X
X                                                                                                                     X
X                                                                                                                     X
X                                                                                                                     X
XXXXXXXXXXXXXXXXXXXXXXXXXXXXXXXXXXXXXXXXXXXXXXXXXXXXXXXXXXXXXXXXXXXXXXXXXXXXXXXXXXXXXXXXXXXXXXXXXXXXXXXXXXXXXXXXXXXXXXX