XXXXXXXXXXXXXXXXXXXXXXXXXXXXXXXXXXXXXXXXXXXXXXXXXXXXXXXXXXXXXXXXXXXXXXXXXXXXXXXXXXXXXXXXXXXXXXXXXXXXXXXXXXXXXXXXXXXXXXX
X                                                                                                                     X
X                                                                                                                     X
X                                                                                                                     X
X                                                                                                                     X
X                                                                                                                     X
X                                                                                                                     X
X                                                                                                                     X
X                                                                                                                     X
X                                                                                                                     X
X                                                                                                                     X
X                                                                                                                     X
X                                                                                                                     X
X                                          XXXXXXXXX                                                                  X
X                                          X  X  X X                                                                  X
X                                          X       X                                                                  X
X                                          X   X   X                                                                  X
X                                          XX X    XXXXXXXX XXXXXXXX                                                  X
X                                          X  X                    X                                                  X
X                                          XX XX X XXXXXXXXXXXXXX  X                                                  X
X                                          X  XX   X               X                                                  X
X                                          XX X    XXXXXXXXX XXXXXXX                                                  X
X                                          X    X  X       X X                                                        X
X                                          XX X    XX XXXX   X                                                        X
X                                          X       X       X X                                                        X
X                                          XX X  X XXXXXXXXX X                                                        X
X                                          X  PBOX           X                                                        X
X                                          XXXXXXXXXXXXXXXXXXX                                                        X
X                                                  0                                                                  X
X                                                                                                                     X
X                                                                                                                     X
X                                            XXXXXXXXXXXXXXXXXXXXXXXXXXXXXXXXXXXX XXXXXXXXXXXXXXXXXXXXXXXXXXXXXXXXX   X
X                                            XR                                                                   X   X
X                                            XXXXXXXXXXXXXXXXXXXXXXXXXXXXXXXXXXXXXXXXXXXXXXXXXXXXXXXXXXXXXXXXXXXXXX   X
X                                                                                                                     X
X                                                                                                                     X
X                                                                                                                     X
X                                                                                                                     X
X                                                                                                                     X
X                                                                                                                     X
X                                                                                                                     X
X                                                                                                                     X
X                                                                                                                     X
X                                                                                                                     X
XXXXXXXXXXXXXXXXXXXXXXXXXXXXXXXXXXXXXXXXXXXXXXXXXXXXXXXXXXXXXXXXXXXXXXXXXXXXXXXXXXXXXXXXXXXXXXXXXXXXXXXXXXXXXXXXXXXXXXX