XXXXXXXXXXXXXXXXXXXXXXXXXXXXXXXXXXXXXXXXXXXXXXXXXXXXXXXXXXXXXXXXXXXXXXXXXXXXXXXXXXXXXXXXXXXXXXXXXXXXXXXXXXXXXXXXXXXXXXX
X                                                                                                                     X
X                                                                                                                     X
X                                                                                                                     X
X                                                                                                                     X
X                                                                                                                     X
X                                                                                                                     X
X                                                XXXXXXXXXXXXXXXXXXXXXXXXXXXXXXXXXXXXXXXX                             X
X                                                X                                      X                             X
X                                                X XXXXXXXX XXXXXXXXXXXXXXXXXXXXXXXXXXX X                             X
X                                                X X      X X                         X X                             X
X                                                X X      X X                         X X                             X
X                                                X X      X X                         X X                             X
X                                          XXXXXXX X      X XXXXXXXXXXXXXXXXXXXXXXXXXXX XXXXXXXX                      X
X                                          X XX XX X      X                              B     X                      X
X                                          X X     X      X XXXXXXXXXXXXXXXXXXXXX XXXXXXXXXXXX X                      X
X                                          X   X   X      X X                   X X          X X                      X
X                                          XX XX  XXXXXXXXX XXXXXXXX            X X          X X                      X
X                                          XP X                    X            X X          X X                      X
X                                          XX XX X XXXXXXXXXXXXXX  XXXXXXXXXXXXXX XXXXXXXXXXXX XXXXXXXXXXXXXXXXXXX    X
X                                          X  XX   X                                                             X    X
X                                          XX X    XXXXXXXXX XXXXXXXXXXXXXXXX XXXXXXXX XXXXXXXXXXXXXXXXXXXXXXXXX X    X
X                                          X    X          X X              X X                                X X    X
X                                          XX X    XX XXXX   X  XXXXXXXXXX  X X XXXXXXXXXXXXXXXXXXXXXXXXXXXXXX X X    X
X                                          X       X       X X  X   O    X  X X X                           X  X X    X
X                                   XXXXXXXXXXX XX XXXXXXXXX X  X       XX  X X X XXXXXXXXXXXX XXXXXXX XXXX X XX X    X
X                                   X            X           X  XXXX XXXXX  X X X X          X X          X X  X X    X
X                                   X XXXXXXXXXXXXXXXXXXX XXXX     X X      X X X XXXXXXXX XXX XXXXXXXXXXXX XX X X    X
X                                   X X                 X X        X X      X X X                           X  X X    X
X                                   X X                 X X        X X      X X X XXXXX XXXXXX XXXXXXXXXXXX X XX X    X
X                                   X X                 X X        X X      X X X X          X X          X X  X X    X
X                                   X XXXXXXXXXXXXXXXXXXX XXXXXXXXXX XXXXXXXX XXX XXXXXXXXXXXX XXXX XXXXXXX XXXX XXXX X
X                                   X          R                                                                    X X
X                                   XXXXXXXXXXXXXXXXXXXXXXXXXXXXXXXXXXXXXXXXXXXXXXXXXXXXXXXXXXXXXXXXXXXXXXXXXXXXXXXXX X
X                                                            0                                                        X
X                                                                                                                     X
X                                                                                                                     X
X                                                                                                                     X
X                                                                                                                     X
X                                                                                                                     X
X                                                                                                                     X
X                                                                                                                     X
X                                                                                                                     X
X                                                                                                                     X
XXXXXXXXXXXXXXXXXXXXXXXXXXXXXXXXXXXXXXXXXXXXXXXXXXXXXXXXXXXXXXXXXXXXXXXXXXXXXXXXXXXXXXXXXXXXXXXXXXXXXXXXXXXXXXXXXXXXXXX